Test Testatory 1
An Interactive Fiction
Release 1 / Serial number 210817 / Inform 7 build 6M62 (I6/v6.33 lib 6/12N) SD

tomo suli
sina lukin e tu kilis, an ijo, a supa (on which is an ilo suno), a poki (closed) and jan Nasin lon ni.

>take kili
Taken.

>x kili
You see nothing special about the kili.

>take kili
Taken.

>io
That's not a verb I recognise.

>i
You are carrying:
  two kilis

* * *

>take kili
Taken.

>drop
(the kili)
Dropped.

two kilis

* * *

>take kili
Taken.

>i
sina jo:
  a kili

jan Nasin li alasa lon ijo ona.

>i
You are carrying:
  mute kilis

>look
Tomo Suli
You can see a kili here.

>take kili
Taken.

>i
You are carrying:
  mute kilis

* * *

>i
sina jo:
  a kili

jan Nasin li alasa lon ijo ona.

>go nasin lete
You can't see any such thing.

>go north
You can't go that way.

>go sewi
You can't see any such thing.

>go the up
You can't go that way.

>go the insa
You can't see any such thing.

>go insa
You can't see any such thing.

* * *

>i
sina jo:
  a kili

jan Nasin li alasa lon ijo ona.

>n
They can't go that way.

>go
ona li tawa ala tan ona li sitelen e nasin.

* * *

>i
sina jo:
  a kili

jan Nasin li alasa lon ijo ona.

>x jan Nasin
You see nothing special about jan Nasin.

>take kili
Taken.

    *** The End ***

Would you like to RESTART, RESTORE a saved game, QUIT or UNDO the last command?

>undo
tomo suli
[Previous turn undone.]

>take ijo
Taken.

>take ijo
sina ken ala tawa jo e ijo tan ni: tenpo ni la sina jo e ona.

* * *

Test Testatory 1
An Interactive Fiction
Release 1 / Serial number 210817 / Inform 7 build 6M62 (I6/v6.33 lib 6/12N) SD

tomo suli
sina lukin e tu kilis, an ijo, a supa (on which is an ilo suno), a poki (closed) and jan Nasin lon ni.

>go north
You can't go that way.

>go
sina tawa ala tan sina sitelen e nasin.

* * *

Test Testatory 1
An Interactive Fiction
Release 1 / Serial number 210817 / Inform 7 build 6M62 (I6/v6.33 lib 6/12N) SD

tomo suli
sina lukin e tu kilis, an ijo, a supa (on which is an ilo suno), a poki (closed) and jan Nasin lon ni.

>g
You can hardly repeat that.

>take kili
Taken.

    *** The End ***

Would you like to RESTART, RESTORE a saved game, QUIT or UNDO the last command?

>i
Please give one of the answers above.

Would you like to RESTART, RESTORE a saved game, QUIT or UNDO the last command?

* * *

Test Testatory 1
An Interactive Fiction
Release 1 / Serial number 210817 / Inform 7 build 6M62 (I6/v6.33 lib 6/12N) SD

tomo suli
sina lukin e tu kilis, an ijo, a supa (on which is an ilo suno), a poki (closed) and jan Nasin lon ni.

>go
sina tawa ala tan sina sitelen e nasin.

>take kili
Taken.

* * *

>i
sina jo:
  a kili

jan Nasin li alasa lon ijo ona.

>take ilo
You can't see any such thing.

>i
sina jo:
  a kili

>take kili
Taken.

    *** The End ***

Would you like to RESTART, RESTORE a saved game, QUIT or UNDO the last command?

* * *

>i
sina jo:
  a kili

jan Nasin li alasa lon ijo ona.

>take ijo
Taken.

>i
sina jo:
  an ijo
  a kili

jan Nasin li alasa lon ijo ona.

>take kili
Taken.

    *** The End ***

Would you like to RESTART, RESTORE a saved game, QUIT or UNDO the last command?

* * *

>go
sina tawa ala tan sina sitelen e nasin.

>take me
sina ken ala tawa jo e yourself tan ni: sina jo e sina.

>take kili
Taken.

* * *

>take kili
Taken.

    *** The End ***

Would you like to RESTART, RESTORE a saved game, QUIT or UNDO the last command?

>restart
Test Testatory 1
An Interactive Fiction
Release 1 / Serial number 210816 / Inform 7 build 6M62 (I6/v6.33 lib 6/12N) SD

tomo suli
sina can see tu kilis, an ijo and jan Nasin lon ni.

>x jan
You see nothing special about jan Nasin.

>take ilo
That seems to belong to jan Nasin.

>take north
You must name something more substantial.

* * *

Test Testatory 1
An Interactive Fiction
Release 1 / Serial number 210817 / Inform 7 build 6M62 (I6/v6.33 lib 6/12N) SD

tomo suli
sina lukin e tu kilis, an ijo, a supa (on which is an ilo suno), a poki (closed) and jan Nasin lon ni.

>take jan
jan Nasin li wile ala e ni.

>i
sina jo ala.

jan Nasin li alasa lon ijo ona.

* * *

Test Testatory 1
An Interactive Fiction
Release 1 / Serial number 210817 / Inform 7 build 6M62 (I6/v6.33 lib 6/12N) SD

tomo suli
sina lukin e tu kilis, an ijo, a supa (on which is an ilo suno), a poki (closed) and jan Nasin lon ni.

>take nena
sina ken ala jo e nena weka.

>x nena weka
You see nothing special about nena weka.

>l
tomo suli
sina lukin e tu kilis, an ijo, a supa (on which is an ilo suno) and jan Nasin lon ni.

>stand on supa
That's not something you can stand on.

* * *

Test Testatory 1
An Interactive Fiction
Release 1 / Serial number 210817 / Inform 7 build 6M62 (I6/v6.33 lib 6/12N) SD

tomo suli
sina lukin e tu kilis, an ijo, a supa (on which is an ilo suno), a poki (closed) and jan Nasin lon ni.

>open poki
You open the poki, revealing a poki moku.

>l
tomo suli
sina lukin e tu kilis, an ijo, a supa (on which is an ilo suno), a poki (in which is a poki moku) and jan Nasin lon ni.

>take tu kili
kili: Taken.
kili: Taken.

    *** The End ***

Would you like to RESTART, RESTORE a saved game, QUIT or UNDO the last command?