Toki Pona Tests
An Interactive Fiction by Eli
Release 1 / Serial number 210819 / Inform 7 build 6M62 (I6/v6.33 lib 6/12N) SD

tomo suli
sina lukin e tu kili, an ijo, a supa, a poki (closed) and jan Ili lon ni.

>take wan kili
tawa jo.

>i
sina jo:
  a kili

>go nasin lete
(nasin lete)
You can't go that way.

>nasin lete
You can't go that way.

>go nasin pi
Which do you mean, the nasin pi open suno or the nasin pi suno pini?

>open
(nasin lete)
You must name something more substantial.

>go insa
You can't go that way.

* * *

Toki Pona Tests
An Interactive Fiction by Eli
Release 1 / Serial number 210819 / Inform 7 build 6M62 (I6/v6.33 lib 6/12N) SD

tomo suli
sina lukin e tu kili, an ijo, a supa, a poki (closed) and jan Ili lon ni.

>nasin lete
tomo lili

>nasin sele
Which do you mean, the nasin lete, the nasin lete poka open suno, the nasin lete poka suno pini, the nasin seli, the nasin seli poka open suno, the nasin seli poka suno pini, the nasin pi open suno or the nasin pi suno pini?

>nasin
Which do you mean, the nasin lete, the nasin lete poka open suno, the nasin lete poka suno pini, the nasin seli, the nasin seli poka open suno, the nasin seli poka suno pini, the nasin pi open suno or the nasin pi suno pini?

>nasin seli
I only understood you as far as wanting to (go) nasin.

>nasin seli
tomo suli
sina lukin e tu kili, an ijo, a supa and a poki (closed) lon ni.

>nasin lete
tomo lili

>nasin seli
tomo suli
sina lukin e tu kili, an ijo, a supa and a poki (closed) lon ni.

* * *

Toki Pona Tests
An Interactive Fiction by Eli
Release 1 / Serial number 210819 / Inform 7 build 6M62 (I6/v6.33 lib 6/12N) SD

tomo suli
sina lukin e tu kili, an ijo, a supa, a poki (closed) and jan Ili lon ni.

>eat
What do you want to eat?

I beg your pardon?

I beg your pardon?

>d
You can't see any such thing.

>ask
What do you want to ask yourself for?

I beg your pardon?

>s
You can't see any such thing.

>cut
What do you want to cut?

>me
Cutting you up would achieve little.

* * *

Toki Pona Tests
An Interactive Fiction by Eli
Release 1 / Serial number 210819 / Inform 7 build 6M62 (I6/v6.33 lib 6/12N) SD

tomo suli
sina lukin e tu kili, an ijo, a supa, a poki (closed) and jan Ili lon ni.

>take kili
tawa jo.

* * *

Toki Pona Tests
An Interactive Fiction by Eli
Release 1 / Serial number 210819 / Inform 7 build 6M62 (I6/v6.33 lib 6/12N) SD

tomo suli
sina lukin e tu kili, an ijo, a supa, a poki (closed) and jan Ili lon ni.

>l
tomo suli
sina lukin e tu kili, an ijo, a supa and a poki (closed) lon ni.

>l
tomo suli
sina lukin e tu kili, an ijo, a supa and a poki (closed) lon ni.

* * *

Toki Pona Tests
An Interactive Fiction by Eli
Release 1 / Serial number 210819 / Inform 7 build 6M62 (I6/v6.33 lib 6/12N) SD

tomo suli
sina lukin e tu kili, an ijo, a supa, a poki (closed) and jan Ili lon ni.

>take red
You can't see any such thing.

>tak aerasdfs
mi sona ala e nimi pali ni.

>take aerasdfs
You can't see any such thing.

>take him
I'm not sure what 'him' refers to.

>take it
tawa jo.

>i
sina jo:
  a poki (closed)

>n
tomo lili

>take it
sina ken ala tawa jo e poki tan ni: tenpo ni la sina jo e ona.

>sorry
Oh, don't apologise.

>sorry
Oh, don't apologise.

>oopz
mi sona ala e nimi pali ni.

>oops
Sorry, that can't be corrected.

>take all
There are none at all available!

>s
tomo suli
sina lukin e tu kili, an ijo and a supa lon ni.

>take all
kili: tawa jo.
kili: tawa jo.
ijo: tawa jo.

    *** The End ***

Would you like to OPEN SIN, RESTORE a saved game, PIPI or UNDO the last command?

>open sin
Toki Pona Tests
An Interactive Fiction by Eli
Release 1 / Serial number 210818 / Inform 7 build 6M62 (I6/v6.33 lib 6/12N) SD

tomo suli
sina lukin e tu kili, an ijo, a supa and a poki (closed) lon ni.

>take all
kili: tawa jo.
kili: tawa jo.
ijo: tawa jo.
poki: tawa jo.

    *** The End ***

Would you like to OPEN SIN, RESTORE a saved game, PIPI or UNDO the last command?

* * *

Toki Pona Tests
An Interactive Fiction by Eli
Release 1 / Serial number 210819 / Inform 7 build 6M62 (I6/v6.33 lib 6/12N) SD

tomo suli
sina lukin e tu kili, an ijo, a supa, a poki (closed) and jan Ili lon ni.

>tawa jo e kili
tawa jo.

>weka e kili
pana.

>i
sina jo ala.

* * *

Toki Pona Tests
An Interactive Fiction by Eli
Release 1 / Serial number 210819 / Inform 7 build 6M62 (I6/v6.33 lib 6/12N) SD

tomo suli
sina lukin e tu kili, an ijo, a supa, a poki (closed) and jan Ili lon ni.

>take
What do you want to take off?

>i
You can't see any such thing.

>i
mi sona ala e nimi pali ni.

>tawa jo e kili
tawa jo.

>a
sina jo:
  a kili

>moku e kili
That's plainly inedible.

>insa e kili lon supa
That can't contain things.

>insa e kili lon poki
The poki is closed.

>open poki
You open the poki.

>insa e kili lon poki
You put the kili into the poki.

>tawa jo e kili
tawa jo.

>l
tomo suli
sina lukin e an ijo, a supa and a poki (in which is a kili) lon ni.

>weka e ijo
There are none at all available!

>remove kili from poki
tawa jo.

    *** The End ***

Would you like to OPEN SIN, RESTORE a saved game, PIPI or PALI WEKA e toki wawa nanpa pini?

* * *

Toki Pona Tests
An Interactive Fiction by Eli
Release 1 / Serial number 210819 / Inform 7 build 6M62 (I6/v6.33 lib 6/12N) SD

tomo suli
sina lukin e tu kili, an ijo, a supa, a poki (closed) and jan Ili lon ni.

>tawa anpa
But you aren't in anything at the moment.

>tawa sewi
You can't go that way.

* * *

Toki Pona Tests
An Interactive Fiction by Eli
Release 1 / Serial number 210819 / Inform 7 build 6M62 (I6/v6.33 lib 6/12N) SD

tomo suli
sina lukin e tu kili, an ijo, a supa, a poki (closed) and jan Ili lon ni.

>x kili
mi sona ala e nimi pali ni.

>l kili
I only understood you as far as wanting to look.

>l e kili
You see nothing special about the kili.

* * *

Toki Pona Tests
An Interactive Fiction by Eli
Release 1 / Serial number 210819 / Inform 7 build 6M62 (I6/v6.33 lib 6/12N) SD

tomo suli
sina lukin e tu kili, an ijo, a supa, a poki (closed) and jan Ili lon ni.

>amusing
mi sona ala e nimi pali ni.

* * *

Toki Pona Tests
An Interactive Fiction by Eli
Release 1 / Serial number 210819 / Inform 7 build 6M62 (I6/v6.33 lib 6/12N) SD

tomo suli
sina lukin e tu kili, an ijo, a supa, a poki (closed) and jan Ili lon ni.

>pali weka
mi sona ala e nimi pali ni.

>w
You can't go that way.

>z
Time passes.

>pali weka
mi sona ala e nimi pali ni.

>pali
mi sona ala e nimi pali ni.

>undo
mi sona ala e nimi pali ni.

>oops
Sorry, that can't be corrected.

* * *

Toki Pona Tests
An Interactive Fiction by Eli
Release 1 / Serial number 210819 / Inform 7 build 6M62 (I6/v6.33 lib 6/12N) SD

tomo suli
sina lukin e tu kili, an ijo, a supa, a poki (closed) and jan Ili lon ni.

>tawa jo all
I only understood you as far as wanting to tawa.

>tawa jo ale
I only understood you as far as wanting to tawa.

>tawa jo e ale
kili: tawa jo.
kili: tawa jo.
ijo: tawa jo.
poki: tawa jo.

    *** The End ***

Would you like to OPEN SIN, RESTORE a saved game, PIPI or PALI WEKA e toki wawa nanpa pini?

>pali weka
tomo suli
[Previous turn undone.]

>tawa jo e ale
kili: tawa jo.
kili: tawa jo.
ijo: tawa jo.
poki: tawa jo.

    *** The End ***

Would you like to OPEN SIN, RESTORE a saved game, PIPI or PALI WEKA e toki wawa nanpa pini?

* * *

>pali weka
tomo suli
[Previous turn undone.]

>pali weka
mi sona ala e nimi pali ni.

* * *

Toki Pona Tests
An Interactive Fiction by Eli
Release 1 / Serial number 210819 / Inform 7 build 6M62 (I6/v6.33 lib 6/12N) SD

tomo suli
sina lukin e tu kili, an ijo, a supa, a poki (closed) and jan Ili lon ni.

>pini
What do you want to pini e?

>x
You can't see any such thing.

>tawa jo e ale taso kili
kili: tawa jo.
ijo: tawa jo.
poki: tawa jo.

* * *

Toki Pona Tests
An Interactive Fiction by Eli
Release 1 / Serial number 210819 / Inform 7 build 6M62 (I6/v6.33 lib 6/12N) SD

tomo suli
sina lukin e tu kili, an ijo, a supa, a poki (closed) and jan Ili lon ni.

>todo
sina wile sitelen e nimi ijo.

* * *

Toki Pona Tests
An Interactive Fiction by Eli
Release 1 / Serial number 210819 / Inform 7 build 6M62 (I6/v6.33 lib 6/12N) SD

tomo suli
sina lukin e tu kili, an ijo, a supa, a poki (closed) and jan Ili lon ni.

>purloin
What do you want to purloin?

>jan Nasin
[Purloined.]

>drop jan
mi sona ala e nimi pali ni.

>i
mi sona ala e nimi pali ni.

>pana e jan
(tawa jan Nasin)
Jan Nasin doesn't seem interested.

>alasa
sina jo:
  jan Nasin

jan Nasin li alasa lon ijo ona.

>weka e jan
pana.

>pana e kili tawa jan
(first taking the kili)
Jan Nasin doesn't seem interested.

>pana lukin e kili tawa jan
Jan Nasin is unimpressed.

>kama lupe ala e jan
That seems unnecessary.

>pana wawa e kili tawa jan
You lack the nerve when it comes to the crucial moment.

>utala e jan
Violence isn't the answer to this one.

>fuck
mi sona ala e nimi pali ni.

>uta olin e jan
Jan Nasin might not like that.

>uta e jan
Jan Nasin might not like that.

>luka olin e jan
Jan Nasin might not like that.

>touch jan
Jan Nasin might not like that.

* * *

Toki Pona Tests
An Interactive Fiction by Eli
Release 1 / Serial number 210819 / Inform 7 build 6M62 (I6/v6.33 lib 6/12N) SD

tomo suli
sina lukin e tu kili, an ijo, a supa, a poki (closed) and jan Ili lon ni.

>tawa e ijo tawa weka mi
You can't use multiple objects with that verb.

>tawa e ijo tawa mi
You can't use multiple objects with that verb.

>actions
Actions listing on.

>tawa e ijo tawa weka mi
You can't use multiple objects with that verb.

>tree
compass (584799) 
  the nasin lete
  the nasin lete poka open suno
  the nasin lete poka suno pini
  the nasin seli
  the nasin seli poka open suno
  the nasin seli poka suno pini
  the nasin pi open suno
  the nasin pi suno pini
  the sewi
  the anpa
  the insa
  the selo
(darkness object) (584831) 
(Inform Parser) (584863) 
(Inform Library) (584895) 
(property_numberspace_forcer) (584927) 
(ValuePropertyHolder_43) (584991) 
(ValuePropertyHolder_47) (585023) 
tomo suli (586015) 
  nena weka
  yourself
  tu kili
  an ijo
  a supa
  a poki (closed)
supa (586239) 
  an ilo suno
poki (586303) 
  a poki telo
tomo lili (586367) 
jan Nasin (586399) 
jan Ili (586431) 
  ilo toki

>showheap
32756 of 32784 bytes free.

>showverb tawa
Verb 'tawa' 
     * -> Go
     * 'insa' / 'lon' -> Enter
     * 'ete' / 'weka' -> Exit
     * noun=Routine(343157) -> Go
     * 'insa' / 'lon' noun -> Enter
     * 'e' noun -> Push
     * 'anpa' 'e' noun -> GetOff
     * 'wawa' / 'mute' 'e' noun -> Wave
     * 'e' noun 'tawa' Routine(343972) -> Pull
     * 'e' noun 'tawa' 'weka' Routine(343972) -> Push

>showverb tawa e ijo
I only understood you as far as wanting to showverb that.

>showverb tawa
Verb 'tawa' 
     * -> Go
     * 'insa' / 'lon' -> Enter
     * 'ete' / 'weka' -> Exit
     * noun=Routine(343157) -> Go
     * 'insa' / 'lon' noun -> Enter
     * 'e' noun -> Push
     * 'anpa' 'e' noun -> GetOff
     * 'wawa' / 'mute' 'e' noun -> Wave
     * 'e' noun 'tawa' Routine(343972) -> Pull
     * 'e' noun 'tawa' 'weka' Routine(343972) -> Push

>tawa e ijo
You can't use multiple objects with that verb.

* * *

Toki Pona Tests
An Interactive Fiction by Eli
Release 1 / Serial number 210819 / Inform 7 build 6M62 (I6/v6.33 lib 6/12N) SD

tomo suli
sina lukin e tu kili, an ijo, a supa, a poki (closed) and jan Ili lon ni.

>mi
I didn't understand that sentence.

>sina
I didn't understand that sentence.

>ona
Time passes.

>tawa e ijo
You can't use multiple objects with that verb.

* * *

Toki Pona Tests
An Interactive Fiction by Eli
Release 1 / Serial number 210819 / Inform 7 build 6M62 (I6/v6.33 lib 6/12N) SD

tomo suli
sina lukin e tu kili, an ijo, a supa, a poki (closed) and jan Ili lon ni.

>tawa e ijo
You can't use multiple objects with that verb.

>showme tawa
nasin lete - direction
singular-named, improper-named; list grouping key: none
printed name: "nasin lete"
printed plural name: "nasin tawa"
indefinite article: "the"
opposite: nasin seli
nasin seli - direction
singular-named, improper-named; list grouping key: none
printed name: "nasin seli"
printed plural name: "nasin tawa"
indefinite article: "the"
opposite: nasin lete
nasin lete poka open suno - direction
singular-named, improper-named; list grouping key: none
printed name: "nasin lete poka open suno"
printed plural name: "nasin tawa"
indefinite article: "the"
opposite: nasin seli poka suno pini
nasin lete poka suno pini - direction
singular-named, improper-named; list grouping key: none
printed name: "nasin lete poka suno pini"
printed plural name: "nasin tawa"
indefinite article: "the"
opposite: nasin seli poka open suno
nasin seli poka open suno - direction
singular-named, improper-named; list grouping key: none
printed name: "nasin seli poka open suno"
printed plural name: "nasin tawa"
indefinite article: "the"
opposite: nasin lete poka suno pini
nasin seli poka suno pini - direction
singular-named, improper-named; list grouping key: none
printed name: "nasin seli poka suno pini"
printed plural name: "nasin tawa"
indefinite article: "the"
opposite: nasin lete poka open suno
nasin pi open suno - direction
singular-named, improper-named; list grouping key: none
printed name: "nasin pi open suno"
printed plural name: "nasin tawa"
indefinite article: "the"
opposite: nasin pi suno pini
nasin pi suno pini - direction
singular-named, improper-named; list grouping key: none
printed name: "nasin pi suno pini"
printed plural name: "nasin tawa"
indefinite article: "the"
opposite: nasin pi open suno
sewi - direction
singular-named, improper-named; list grouping key: none
printed name: "sewi"
printed plural name: "nasin tawa"
indefinite article: "the"
opposite: anpa
anpa - direction
singular-named, improper-named; list grouping key: none
printed name: "anpa"
printed plural name: "nasin tawa"
indefinite article: "the"
opposite: sewi
insa - direction
singular-named, improper-named; list grouping key: none
printed name: "insa"
printed plural name: "nasin tawa"
indefinite article: "the"
opposite: selo
selo - direction
singular-named, improper-named; list grouping key: none
printed name: "selo"
printed plural name: "nasin tawa"
indefinite article: "the"
opposite: insa

>showverb tawa
Verb 'tawa' 
     * 'e' noun -> Push

>tawa e kili
Nothing obvious happens.

>tawa e poki
Nothing obvious happens.

>tawa e ijo
You can't use multiple objects with that verb.

>tawa jo e ijo
I didn't understand that sentence.

>tawa jo ijo
I didn't understand that sentence.

>kama jo ijo
I didn't understand that sentence.

>kama jo e ijo
(the ijo)
tawa jo.

>luke e ijo
You can't use multiple objects with that verb.

* * *

Toki Pona Tests
An Interactive Fiction by Eli
Release 1 / Serial number 210819 / Inform 7 build 6M62 (I6/v6.33 lib 6/12N) SD

tomo suli
sina lukin e tu kili, an ijo, a supa, a poki (closed) and jan Ili lon ni.

>luke e ijot
You can't see any such thing.

>luke e poki
You feel nothing unexpected.

>abstract jan tomo
I didn't understand that sentence.

>nasin
I didn't understand that sentence.

>luke e jan
Jan Ili might not like that.

>luke e ijo
You can't use multiple objects with that verb.

* * *

Toki Pona Tests
An Interactive Fiction by Eli
Release 1 / Serial number 210819 / Inform 7 build 6M62 (I6/v6.33 lib 6/12N) SD

tomo suli
sina lukin e tu kili, an ijo, a supa, a poki (closed) and jan Ili lon ni.

>kama jo ijo
I didn't understand that sentence.